--------------------------###-----------
------------------------#####-----------
-----------------------###--------------
----------------------------------------
-----------------------------##---------
----########------------------------###-
-----------#---------------------###----
-----------#------------------###-------
-----------#---------------###----------
----########------------###-------------
----------------------------------------
------------------------------####------
------------------------------####------
------------------------------####------
----------------------------------------
