########################################
#------#------#---#--------------------#
#------#-----#---#--##--------#--------#
#------#----#---#--#--#--------#-------#
########-------#---#---#--------#------#
#-----#-----------------#--------#-----#
#----------#-------------#--------#----#
#---------#---------------#--------#---#
#--------------------------#--------#--#
#---------------------------#--------#-#
#------------############-----#--------#
#------------#----------#--------------#
#------------#----------#--------------#
#------------#----------#--------------#
########################################
